...#.#
..##.#.####
.##..###..#
##........
....@..#...
###..###..#
.##.####  #