...#.#
..##.#.####
.##..###..#
....@..#...
###..###..#
..#..#....#
.##.##.#.##
.#......##
.#.....##
.##.####