...#.#
..##.#.####
.##.##....#
...#@#.#...
########..#
..#..#....#
.##....#.##
.#........
.#.....##
.##.####